Can the snake escape from the factory?
9
3
9
100
2222222000002222222
2111112222222111112
2111111111111111112
2111112222222111112
2111112000002111112
2111112000002111112
2212222000002222122
2111112000002111112
2111112000002111112
2111112222222111112
2111111111111111112
2111112222222111112
2222222000002222222
