The snake entered someone's home.
10
3
4
175
0000000000000000000000000000000
0222222222222222222222222222220
0211111111111111121111111211120
0211111111111111121111111211120
0211222222222221111111211111120
0211111111111111111111211111120
0222222112222222222222211222220
0211112112111121111111211111120
0211111111111121111111211111120
0211111111111111112111211111120
0211112112111111112111211111120
0222222222222222222222222222220
0000000000000000000000000000000
