The snake infiltraded a farmer's land
10
3
4
150
0000000000000000000000000000000
0222222222222222222222222222220
0200000000000000000000000000020
0201010101010101010101010101020
0200000000000000000000000000020
0201010101010101010101010101020
0200000000000000000000000000020
0201010101010101010101010101020
0200000000000000000000000000020
0201010101010101010101010101020
0200000000000000000000000000020
0222222222222000222222222222220
0000000000002555200000000000000
0000000000002555200000000000000
0000000000002222200000000000000
0000000000000000000000000000000
