This is a test map.
2
3
4
8
0000000000000000000000000000000
0222222222222222222222222222220
0200000000000000000000000000020
0200011111111111111111111100020
0200000000000000000000000000020
0222222222222222222222222222220
0000000000000000000000000000000
