Is the snake a round or a cross?
20
11
11
155
000000000000000000000
022222222222222222220
025000520555025000520
020505025000520505020
020050005000500050020
020505025000520505020
025000520555025000520
022202222202222202220
025000520555020555020
020505025000525000520
020050005000505000520
020505025000525000520
025000520555020555020
022202222202222202220
020555025000520555020
025000520505025000520
025000500050005000520
025000520505025000520
020555025000520555020
022222222222222222220
000000000000000000000
